include terrain.map
title Looper
desc Round and round we go.
start 1 1
end 8 9

map
#################
#+###############
#v<<<<<<<<<<<<<<#
#vvvvvv<v>vvvvv^#
#vvvvv<<v>>vvvv^#
#vvvv<<<v>>>vvv^#
#vvv<<<<v>>>>vv^#
#vv<<<<<v>>>>>v^#
#v<<<<<<v>>>>>>^#
#v>>>>>>+<<<<<<^#
#v<<<<<<^>>>>>>^#
#v^<<<<<^>>>>>^^#
#v^^<<<<^>>>>^^^#
#v^^^<<<^>>>^^^^#
#v^^^^<<^>>^^^^^#
#v^^^^^<^>^^^^^^#
#>>>>>>>>>>>>>>^#
#################
