include terrain.map
title Mover
desc Round and round it goes.
start 1 1
end 10 10
movable Box 10 6
landscape Corner 7 7 south-east
landscape Corner 14 7 south-west
landscape Corner 13 13 north-west
landscape Corner 7 13 north-east

map
#####################
#+++++++++++++++++++#
#+++++++++++++++++++#
#++>>>>>>>>>>>>>>v++#
#++^+++++++++++++v++#
#++^+++++++++++++v++#
#++^++/////////++v++#
#++^++/////////++v++#
#++^++//+++++//++v++#
#++^++//+++++//++v++#
#++^++//+++++//++v++#
#++^++//+++++//++v++#
#++^++//+++++//++v++#
#++^++/////////++v++#
#++^++/////////++v++#
#++^+++++++++++++v++#
#++^+++++++++++++v++#
#++^<<<<<<<<<<<<<<++#
#+++++++++++++++++++#
#+++++++++++++++++++#
#####################
