include terrain.map
include portal.mod
title Portal
desc The Cake is a Lie
start 2 1
end 15 17
item portal.PortalGunBlue 3 1
item portal.PortalGunOrange 4 1
movable portal.CompanionCube 3 5

map
==================
==++++++++++++++==
===============+==
=[[[[[[[[[[[[[[[[=
=[[[[[[[[[[[[[[[[=
=[[[[[[[[[[[[[[[[=
=[[[[[[[[[[[[[[[[=
=[[[[[[[[[[[[[[[[=
=@@@@@@@@@@@@@@@@=
=@@@@@@@@@@@@@@@@=
=@@@@@@@@@@@@@@@@=
=[[[[[[[[[[[[[[[[=
=[[[[[[[[[[[[[[[[=
=[[[[[[[[[[[[[[[[=
=[[[[[[[[[[[[[[[[=
=[[[[[[[[[[[[[[[[=
==+===============
==++++++++++++++==
==================
