include terrain.map
title Skills
desc Skillz pay the billz.
start 1 1
end 14 21
item HealthPack 1 4 100
item Flippers 7 3
item IceSkates 7 6
item Carabiner 3 13
item Key 10 10
item FlipFlops 1 15
movable IceCube 2 14
movable IceCube 4 14
movable Box 4 15
movable Box 10 18
movable IceCube 12 18

map
################
#+++++yyy++++++#
##############+#
#~~~~~+++~~~~~+#
#+##############
#+/////////////#
#+////+++//////#
#+/////////////#
##############+#
#++++++#+++++++#
#++++++D+++++++#
#++++++#+++++++#
#+=============#
#++++++%%++++++#
#++++++%%++++++#
#++++++%%++++++#
#.............+#
#++++++~~++++++#
#++++++~~++++++#
#++++++~~++++++#
#+##############
#++++++++++++++#
################
