include terrain.map
title Spider Hole
desc Don't look now.
start 10 14
end 10 1
creature Spider 1 1 south
creature Spider 8 9 north
creature Spider 18 12 north
creature Spider 16 1 west

map
######################
#&&&&++++++&&##&&&&+&#
#&&+++&&###+++++++++&#
#&#+&&++&&&&+&&&&+#&&#
#+++#&&++++++&&&&+&&&#
#+&&&&&&&+&&&#&##+&&&#
#+++&&&&&+&&&#+++++++#
###+&&&&&+&&&#+&&&&&+#
#+++++&+++++++&&&&+++#
#+&&&&+&&###&++++++&&#
#+&&&&+&&###+&&&&&+&&#
#+++&&+&&&&&+&&&&&+###
#&&+##+++++++++&&&+###
#&&++++&&#+&&&+++++###
##########+###########
######################
