include terrain.map
title Ice and Snow
desc It's freezing here.
start 1 1
end 6 13
item IceSkates 1 3

map
################
#+///////+/////#
#//////////////#
#//+////////+//#
#//////////////#
#+/////////////#
#//////////////#
#//+/////+////+#
#//////////////#
#//////////////#
#//////////////#
#/////+/////+//#
#//+///////////#
#/////+////////#
#//////////////#
################
