include terrain.map
title Water World
desc Just keep swimming.
start 7 7
end 14 14
item HealthPack 12 11 50
item Flippers 4 4
creature Fish 8 8 east

map
################
#~~~~~~~~~~~~~~#
#~~~~~~~~~~~~~~#
#~~~~~~~~~~~~~~#
#~~~~~~~~~~~~~~#
#~~~~~~~~~~~~~~#
#~~~~~~~~~~~~~~#
#~~~~~~+~~~~~~~#
#~~~~~~~~~~~~~~#
#~~~~~~~~~~~~~~#
#~~~~~~~~~~~~~~#
#~~~~~~~~~~~~~~#
#~~~~~~~~~~~~~~#
#~~~~~~~~~~~~~~#
#~~~~~~~~~~~~~~#
################
