include terrain.map
include space.mod
title The Belt
desc Welcome to The Belt
start 2 2
end 15 22

map
::::::::::::::::::
:================:
:=++++++++++++++=:
:==============+=:
::::::::::::::::::
::::o::::o::::::::
::::::::oooo::::::
:::::::oooooo:::::
::::::::oooo::::::
::::::::::::::::::
::::::::::::::::::
:::::::::::::ooo::
::::::::::::ooooo:
::::::::::::::oo::
::::::::::::::::::
:::::oo:::::::::::
::::ooo:::::::::::
:::ooo::::::::**::
:::::::::::::****:
::oo::::::::::**::
::::::::::::::::::
:=+==============:
:=++++++++++++++=:
:================:
::::::::::::::::::
